WWWWWWWWWWWWWWWWWWWWWWWWWWWWWWWWWWWWWWWWWWWWWWWWWWWWWWWWWWWW
WWWWWWWWWWWWWWWWWWWWWWWWWWWWWWWWWWWWWWWWWWWWWWWWWWWWWWWWWWWW
WWW                                                       WW
WW WWWWWW  WWWWWWWWWW   WWWWWWW         WWWWWWWWW   W     WW
WW  W                                                     WW
WW  W       E                                             WW
WW  WWWW     WWWWWWWWWWW         WWWWWWWW        WWWWWWWWWWW
WW     W                                                  WW
WW     W    W     WWWWWW        WWWWWWWWW                 WW
WW WWWWWW  WWWWWWWWWW   WWWWWWW         WWWWWWWWW   W     WW
WW                                                        WW
WW                            J                           WW
WW  WWWW     WWWWWWWWWWW         WWWWWWWW        WWWWWWWWWWW
WW                                                        WW
WW WWWWWW  WWWWWWWWWW   WWWWWWW         WWWWWWWWW   W     WW
WW  W                                                     WW
WW  W    E                                                WW
WW           WWWWWWWWWWW         WWWWWWWW    E   WWWWWWWWWWW
WW     W                                                  WW
WW     W    W     WWWWWW        WWWWWWWWW                 WW
WW  WWWW     WWWWWWWWWWW         WWWWWWWW        WWWWWWWWWWW
WW     W                   E                              WW
WW     W    W     WWWWWW        WWWWWWWWW                 WW
WWWWWWWWWWWWWWWWWWWWWWWWWWWWWWWWWWWWWWWWWWWWWWWWWWWWWWWWWWWW
WWWWWWWWWWWWWWWWWWWWWWWWWWWWWWWWWWWWWWWWWWWWWWWWWWWWWWWWWWWW