WWWWWWWWWWWWWWWWWWWWWWWWWWWWWWWWWWWWWWWWWWWWWWWWWWWWWWWWWWWW
WWWWWWWWWWWWWWWWWWWWWWWWWWWWWWWWWWWWWWWWWWWWWWWWWWWWWWWWWWWW
WWW            B                                         KWW
WW WWWWWW  WWWWWWWWWW   WWWWWWW         WWWWWWWWW   W     WW
WW  W                         E                           WW
WW  W       E                       K                     WW
WW  WWWW     WWWWWWWWWWWB        WWWWWWWW        WWWWWWWWWWW
WW     W                                                  WW
WW     W    W     WWWDWW        WWWWWWWWW                 WW
WW WWWWWW  WWWWWWWWWW   WWWWWWW         WWWWWWWWW   W     WW
WW                                  B                     WW
WW              B             J                           WW
WW  WWWW     DWWWWWWWWWW         WWWDWWWW        WWWWWWWWWWW
WW                                                        WW
WW WWWWWW  WWWWWWWWWW   WWWWWWW         WWWWWWWWW   W     WW
WW KW                                                     WW
WW  W    E                           K                    WW
WW           WWWWDWWWWWW  B      WWDWWWWW    E   WWWWWWWWWWW
WW     W                                                  WW
WW     W    W     WWWWWW        WDWWWWWWW                 WW
WW  WWWW     WWWWWWWWWWW         DWWWWWWW        WWWWWWWWWWW
WW     W                   E         K                    WW
WW     W    W     WWWWWW        WWWWWWWWW                 WW
WWWWWWWWWWWWWWWWWWWWWWWWWWWWWWWWWWWWWWWWWWWWWWWWWWWWWWWWWWWW
WWWWWWWWWWWWWWWWWWWWWWWWWWWWWWWWWWWWWWWWWWWWWWWWWWWWWWWWWWWW