WWWWWWWWWWWWWWWWWWWWWWWWWWWWWWWWWWWWWWWWWWWWWWWWWWWWWWWWWWWW
WWWWWWWWWWWWWWWWWWWWWWWWWWWWWWWWWWWWWWWWWWWWWWWWWWWWWWWWWWWW
WWW            B                                          WW
WW WWWWWW  WWWWWWWWWW   WWWWWWW         WWWWWWWWW   W     WW
WW  W                         E                           WW
WW  W       E                                             WW
WW  WWWW     WWWWWWWWWWWB        WWWWWWWW        WWWWWWWWWWW
WW     W                                                  WW
WW     W    W     WWWDWW        WWWWWWWWW                 WW
WW WWWWWW  WWWWWWWWWW   WWWWWWW         WWWWWWWWW   W     WW
WW                      K      K                          WW
WW              B            J       K                    WW
WW  WWWW     DWWWWWWWWWW         WWWDWWWW        WWWWWWWWWWW
WW                      K     K                           WW
WW WWWWWW  WWWWWWWWWW   WWWWWWW         WWWWWWWWW   W     WW
WW  W                                                     WW
WW  W    E                                                WW
WW           WWWWDWWWWWW  B      WWDWWWWW    E   WWWWWWWWWWW
WW     W                                                  WW
WW     W    W     WWWWWW        WDWWWWWWW                 WW
WW  WWWW     WWWWWWWWWWW         DWWWWWWW        WWWWWWWWWWW
WW     W                   E                              WW
WW     W    W     WWWWWW        WWWWWWWWW                 WW
WWWWWWWWWWWWWWWWWWWWWWWWWWWWWWWWWWWWWWWWWWWWWWWWWWWWWWWWWWWW
WWWWWWWWWWWWWWWWWWWWWWWWWWWWWWWWWWWWWWWWWWWWWWWWWWWWWWWWWWWW