WWWWWWWWWWWWWWWWWWWWWWWWWWWWWWWWWWWWWWWWWWWWWWWWWWWWWWWWWWWW
W                                                          W
W              B                                           W
W  WWWWWW  WWWWWWWWWW   WWWWWWW         WWWWWWWWW   W      W
W   W                         E                            W
W   W       E                                              W
W   WWWW     WWWWWWWWWWWB        WWWWWWWW        WWWWWWWWWWW
W      W                                                   W
W      W    W     WWWDWW        WWWWWWWWW                  W
W  WWWWWW  WWWWWWWWWW   WWWWWWW         WWWWWWWWW   W      W
W                       K      K                           W
W               B            J       K                     W
W   WWWW     DWWWWWWWWWW         WWWDWWWW        WWWWWWWWWWW
W                       K     K                            W
W  WWWWWW  WWWWWWWWWW   WWWWWWW         WWWWWWWWW   W      W
W   W                                                      W
W   W    E                                                 W
W            WWWWDWWWWWW  B      WWDWWWWW    E   WWWWWWWWWWW
W      W                                                   W
W      W    W     WWWWWW        WDWWWWWWW                  W
W   WWWW     WWWWWWWWWWW         DWWWWWWW        WWWWWWWWWWW
W      W                   E                               W
W      W    W     WWWWWW        WWWWWWWWW                  W
W      W    W     WWWWWW        WWWWWWWWW                  W
WWWWWWWWWWWWWWWWWWWWWWWWWWWWWWWWWWWWWWWWWWWWWWWWWWWWWWWWWWWW