WWWWWWWWWWWWWWWWWWWWWWWWWWWWWWWWWWWWWWWWWWWWWWWWWWWWWWWWWWWW
WWWWWWWWWWWWWWWWWWWWWWWWWWWWWWWWWWWWWWWWWWWWWWWWWWWWWWWWWWWW
WWW      E     D      W    B           W                  WW
WW WWWWWW  WWWWWWWWWWDDDWWWWWWW W W  D  WWWWWWWWW K WDDWDWWW
WW  W    D   B  W       B     E  D   W  W   D W  D  E  W  WW
WW  W       E        W    W       W     D       W  D      WW
WW  WWWW  W  WWWWWWWWWWW    W    WWWWWWWW   W  D WWWWWWWWWWW
WW     W  D   B    D        D            D   E D         WWW
WW     W    W     WWWDWW        WWWWWWWWW          D      WW
WWKWWWWWW  WWWWWWWWWW   WDWWDWW         WWWWWWWWW   W     WW
WW   D    D   D                 W    D   D    D  D   D    WW
WW     D     D  D   D    W   J    D    D    D   D     D  KWW
WW  WWDWDWWWDDWWWWWWWWWW    W    WWWDWWWW        WDWWWWDWWWW
WW                     B                               D  WW
WW WWWDWW  WWDWWWDWWW   DWWWDWW D D  D  WWDWWDWWW   W  D  WW
WW  W       D D  D  D  B      D          D  B       D D   WW
WW  W D  E     D  D    D               D   D    D D    W  WW
WW           WWDWDWDWDWW  D  W  DWWDWWWWW    E   WWWWDWWDWWW
WW     W   K                                    D D K   E WW
WW     W    W      W   W  D  D  WDWWWWWWW  W W     W   W  WW
WW  WWWW  W  WWWWWDWWDWW  W W  W DWWWWWWW     DW WWDWWWDWWWW
WW     W     B             E              WD  W   D       WW
WW     W    W     WWWWWW     W  WWWWWWWWW   W   D         WW
WWWWWWWWWWWWWWWWWWWWWWWWWWWWWWWWWWWWWWWWWWWWWWWWWWWWWWWWWWWW
WWWWWWWWWWWWWWWWWWWWWWWWWWWWWWWWWWWWWWWWWWWWWWWWWWWWWWWWWWWW