WWWWWWWWWWWWWWWWWWWWWWWWWWWWWWWWWWWWWWWWWWWWWWWWWWWWWWWWWWWW
WWWWWWWWWWWWWWWWWWWWWWWWWWWWWWWWWWWWWWWWWWWWWWWWWWWWWWWWWWWW
WWW       E                                              KWW
WW WDWDWW DWDWDWWDWDWD WDWW WDWWDWD WDWDWWDWDWDWWD DWDDWDWWW
WW  W   K     W      W        E           D      D    D   WW
WW  W       E     W          D               D     D E    WW
WW  WDWW     WWDWWWWWWWW         WDWDWDWWD  D  D WWWWWWWWWWW
WWD    W     B        B   D    D          W   D        E  WW
WW     W  D W     WDWDWW        WDDW W DW   D D D  D  D D WW
WW WD D D  WWDDDDWW W D WD W DW    DDD  W DW W W W  W  W  WW
WW    D  W  D D   D  D            WD D    D    D   D   D  WW
WWD D  D   W   DKW  E   D   D J    DWD      D    D   D   DWW
WW  WWWW  D  DWWWWWWWWWW         WWWDWWWW D    D WWWWWWWWWWW
WWD    B       E           B       B         W         E  WW
WW W WDDWW DWDDWWDWDWDWDWDDWWWDW DDW  WD  WD  WD  D W     WW
WWD B    D  B      D  D D    B      D       W          W  WW
WW  W D DE  D   D    D     D    D D  D    D    D  W  W   KWW
WW        D  WWWWDWWWWWW  D  D   WWDWWWWW    E   WDWWWDWDWWW
WW  WD W                                    B     D   D   WW
WW          W     WWWWWW        WDWWWWWWW           D     WW
WWW W W W D  WDWWDWWDWWD  D  D  DDWDWWWDW D  D   DWWDWWWDDWW
WW    W           B        E      B         D   E         WW
WW K E      W     WWWWWW        WWWWWWWWW                 WW
WWWWWWWWWWWWWWWWWWWWWWWWWWWWWWWWWWWWWWWWWWWWWWWWWWWWWWWWWWWW
WWWWWWWWWWWWWWWWWWWWWWWWWWWWWWWWWWWWWWWWWWWWWWWWWWWWWWWWWWWW