WWWWWWWWWWWWWWWWWWWWWWWWWWWWWWWWWWWWWWWWWWWWWWWWWWWWWWWWWWWW
WWWWWWWWWWWWWWWWWWWWWWWWWWWWWWWWWWWWWWWWWWWWWWWWWWWWWWWWWWWW
WW     K E    DDD                                  D K  DEWW
WWDDWDWDW W W W W WDWDWDWDWDWDWDWDWDWDWDWDWDWDWDWDW WDW W WW
WW      D                                          D      WW
WWWDWKWDWDW W WDW W WDW W WDW WDW WDW WDW WDW W WDW W W W WW
WW                     E   D                       D D D DWW
WWDWW W W WDWDW WDW WKW WDW WDW WDWEWDWEWDWDWDWDW W W W WDWW
WW     D           D       D   D                 D D D D  WW
WWWDW W WDW WDW WDW WDW WDW WDW WDW WDWDWDWDW WDW WDW WDW WW
WW        E                                      D   D D  WW
WWDWW WDWDWDW W WDWDWDWDWDWDWWWDWWWDWDWDW WDWDWDWDWDWDW W WW
WW       KD  D               J                           DWW
WWWDW WDWDWDW W W W W W W W W W W W W W W W W W W W W W W WW
WW   D     E D D   D D D D   D D D D D   D D D D D D D D  WW
WWDWW W W W W W W W W W W W W W W W W W W W W W W W W W W WW
WW   D                     E                              WW
WWWDW W W W WDWDWDWDWDWDWDWDWDWDW WDWDWDWDWDWDWDWDWDWDWDWDWW
WW   D                                           E   D    WW
WWDWW W W W W W W W W W W W W W W W W W W W W W W W W W W WW
WW   D   E D D D D D D D D D D D D D D D D D D D  E  KDD  WW
WWWDW W W W W W W W W W W W W W W W W W W W W W W W W W W WW
WW       K                                    E          DWW
WWWWWWWWWWWWWWWWWWWWWWWWWWWWWWWWWWWWWWWWWWWWWWWWWWWWWWWWWWWW
WWWWWWWWWWWWWWWWWWWWWWWWWWWWWWWWWWWWWWWWWWWWWWWWWWWWWWWWWWWW